+--+--+--+--+--+--+--+--+
|p    |     |           |
+  +  +  +  +  +--+--+  +
|  |  |  |     |     |  |
+  +  +  +--+--+  +  +  +
|  |  |           |     |
+  +  +--+--+--+  +--+  +
|  |     |     |     |  |
+  +--+  +  +  +--+  +  +
|     |     |     |  |  |
+  +  +--+--+--+  +  +  +
|  |           |  |  |  |
+  +--+--+--+  +  +  +  +
|           |     |  | g|
+--+--+--+--+--+--+--+--+