+--+--+--+--+
|p          |
+  +--+  +  +
|  |     |  |
+  +  +--+--+
|  |        |
+  +--+--+  +
| E      | g|
+--+--+--+--+