+--+--+--+--+
|p          |
+  +--+  +  +
|  |     |E |
+  +  +--+--+
|  |        |
+  +--+--+  +
|        | g|
+--+--+--+--+